v<<<<<<<<<<<<<<<<<ù<<<<<
vv<<<<<<<<<<<≤≤<<<ù<<<^<
vv#D#########vv#ÛÛ###D^⋜
vv###########vv#^^####^^
vv##########Dvv#^^D###^^
vv#D#########vv#^^####^^
vv<<<<<<ù<<<<≤≤#^^####^^
vv<<<<<<ù<<<<≤≤#^^####^^
vv####ÛÛ#####vv#^^####^^
≥vD##D^⋜####Dv≤#^^####^^
vv####^^#####vv#⋝^D###^^
ǓǓ####^^#####vv#^^####^^
vvù<<<⋜⋜<<<<<<<<⋜⋜<<<<⋜⋜
vvù<<<<<<<<<≤≤<<<<<<<<⋜⋜
vv##########vv###^^###^^
v≥>>>>>>>>≥>>>>>>⋝⋝>>ú^^
v≥>>>>>>>>>>>>>>>>>>>ú^^
vv####vv##D##vv#^^####ÛÛ
vv####vv#####vv#^^####^^
vv####vv#####vv#^^###D^⋜
vv###Dv≤####Dv≤#^^####^^
vv####vv#####vv#^^####^^
vv####ǓǓ#####ǓǓ#^^#D##^^
>>>>>ú>>>>>>ú>>>⋝⋝>>>>^^
>>>>>ú>>>>>>ú>>>>>>>>>>^
